01,02,02,02,02,02,02,02,02,02,02,03,
17,18,18,18,18,18,18,18,18,18,18,19,
17,18,18,18,18,18,18,18,18,18,18,19,
17,18,18,18,48,48,18,18,18,18,18,19,
17,18,18,18,48,67,18,18,18,18,18,19,
17,18,18,18,48,48,18,18,18,18,18,19,
17,18,18,18,18,18,18,18,18,18,18,19,
17,18,18,18,18,18,18,18,18,18,18,19,
33,34,34,34,34,34,34,34,34,34,34,35
