01,02,02,02,02,02,02,02,02,02,02,03,
17,65,65,65,65,18,18,65,65,65,65,19,
17,65,65,65,65,18,18,65,65,65,65,19,
17,18,65,65,18,18,18,18,65,65,18,19,
17,18,18,18,18,18,18,18,18,18,18,19,
17,18,65,65,18,18,18,18,65,65,18,19,
17,65,65,65,65,18,18,65,65,65,65,19,
17,65,65,65,65,18,18,65,65,65,65,19,
33,34,34,34,34,34,34,34,34,34,34,35
